R 1200 1000

NO ./textures/grass_wall.xpm
SO ./textures/natsi_wall.xpm
WE ./textures/colored_rock.xpm
EA ./textures/rock.xpm
S ./path_to_the_sprite_texture

C 220,100,0
F 225,30,0

        1111111111111111111111111
        1000000000110000000000001
        1011000001110000002000001
        1001000000000W00000000001
111111111011000001110000000000001
100000000011000001110111111111111
11110111111111011100000010001
11110111111111011101010010001
11000000110101011100000010001
10000000000000001100000010001
10000000000000001101010010001
11000001110101011111011110001
11110111 1110101 101111010001
11111111 1111111 111111111111