R 1200 800

NO ./textures.64/art-on-wall.xpm
SO ./textures.64/grey-brick.xpm
WE ./textures.64/colored-bricks.xpm
EA ./textures.64/nazi-logo.xpm
S ./textures.64/vase.xpm

C 153,255,255
F 119,58,58

        1111111111111111111111111
        1000000200000000000000001
        1000000200000000000000001
        1000000000000000000000001
111111111011000N01110000000000001
100000000011000001110111111111111
11110111111111011100000010001
11110111111111011101010010001
11000000110101011100000010001
10000000000000001100000010001
10000000000000001101010010001
11000001110101011111011110001
11110111 1110101 101111010001
11111111 1111111 111111111111